NNNNNNNNNNNNNNNNNNNN
NNNNNNNNNNNNNNNNNNNN
NNNNNNNGNNNNNNNNNNNN
NNNPPLPPPLPPPPLPPNNN
NNNNNLNNNLNNNNLNNNNN
NNLPPPPNPPLNNPPPPPLN
NNLNNNNNNNLNNNNNNNLN
NNPPPLNNLPPNNNNLPPPN
NNNNNLNNLNNNNNNLNNNN
NNLPPPNNPPPPLNPPPLNN
NNLNNNNNNNNNLNNNNLNN
NNPPLNNNNNpNLNNLPPNN
NNNNLNNNNPPPPNNLNNNN
1NNNLNNNNNNNNNNLNNN2
PPPPPPPPPPPPPPPPPPPP