NNNNNNNNNNNNNNNNNNNN
NNNNNNNNNNNNNNNNNNNN
NNNNNNNNNNNNNNNNNNNN
PPPPPPPPLPPPPPPLNNNN
NNNNNNNNLNNNNNNLNNNN
NNNNNNNNLNNNNNNLNNNN
NNNNNPPPPNLPPPPPNNNN
NNNNNNNNNNLNNNNNNNNN
NNNNNNNNLPPLNNNNNNNN
NNNNNNNNLNNLNNNNNNNN
NNLPPPPLPPPPLPPPPLNN
NNLNNNNLNNNNLNNNNLNN
NNLNNNNLNNNNLNNNNLNN
NNLNNNNLNNNNLNNNNLNN
PPPPPPPPPPPPPPPPPPPP