NNNNNNNNNNNNNNNNNNNN
NNNNNNNNGNNNNNNNNNNN
NNNNNPPPPPPPPPPNNNNN
NNNNNNNNNNNNNNNNNNNN
NNNNNNNNNpNNNNNNNNNN
NNPPLPPPPPPPPPLPPNNN
NNNNLNNNNNNNNNLNNNNN
NNNNLNNNNNNNNNLNNNNN
NNNNPPPLPNPLPPPNNNNN
NNNNNNNLNNNLNNNNNNNN
NNNNNNNLNNNLNNNNNNNN
NNNNLPPPPLPPPPLNNNNN
NNNNLNNNNLNNNNLNNNNN
NN1NLNNNNLNNNNLN2NNN
PPPPPPPPPPPPPPPPPPPP