NNNNNNNNNNNNNNNNNNNN
NNNNNNNNNNNNNNNNNNNN
NNNNNNNGNNNNNNNNNNNN
PPPPPPPPLPPPPPPLNNNN
NNNNNNNNLNNNNNNLNNNN
NNNNNpNNLNNNNNNLNNNN
NNNNNPPPPNLPPPPPNNNN
NNNNNNNNNNLNNNNNNNNN
NNNNNNNNLPPLNNNNNNNN
NNNNNNNNLNNLNNNNNNNN
NNLPPPPLPPPPLPPPPLNN
NNLNNNNLNNNNLNNNNLNN
NNLNNNNLNNNNLNNNNLNN
1NLNNNNLNNNNLNNNNLN2
PPPPPPPPPPPPPPPPPPPP