NNNNNNNNNNNNNNNNNNNN
NNNNNNNNNNNNNNNNNNNN
NNNNNNNGNNNNNNNNNNNN
NPPPPPPPPPPPPPPPPPPN
NNNNNNNNNNNNNNNNNNNN
NNNNNNpNNNNNNNNNNNNN
NNNNLPPPPLPPPPPLNNNN
NNNNLNNNNLNNNNNLNNNN
NNLPPPNLPPPLNNPPPLNN
NNLNNNNLNNNLNNNNNLNN
NNPLPPPPNNNPPPPPLPNN
NNNLNNNNNNNNNNNNLNNN
NNNPPPLPNNNNPLPPPNNN
NNNNNNLNN2N1NLNNNNNN
PPPPPPPPPPPPPPPPPPPP