NNNNNNNNNNNNNNNNNNNN
NNNNNNNNNNNNNNNNNNNN
NNNNNNNGNNNNNNNNNNNN
NPPPPPPPPPPPPPPPPPPN
NNNNNNNNNNNNNNNNNNNN
NNNNNNNNNLPPPPLNNNNN
NNNNNNNNNLNNNNLNNNNN
NNNLPPPPPPNLPPPPLNNN
NNNLNNNNNNNLNNNNLNNN
PPPPPPLNNLPPPPPPPPLN
NNNNNNLNNLNNNNNNNNLN
NNNNNNLNNLNNNNpNNNLN
NNLPPPPNNPPPPPPPPPPN
1NLN2NNNNNNNNNNNNNNN
PPPPPPPPPPPPPPPPPPPP